0
2,100,300,1000
0,30,1,2,3
2,1,0	3,1,1	4,1,0	5,2,0	6,2,1	7,2,0	8,3,0	9,3,1	10,3,0
2,1,0	3,1,0	4,3,1	5,2,0	6,2,0	7,1,1	8,3,0	9,3,0	
	3,1,0	4,3,0	5,3,0	6,2,0	7,1,0	8,1,0	9,3,0	
	3,3,0	4,3,3	5,3,0	6,1,0	7,1,3	8,1,0		
		4,2,0	5,2,0	6,2,0	7,2,0	8,2,0		
		4,2,0	5,2,0	6,2,0	7,2,0			
			5,2,0	6,2,1	7,2,0			
			5,2,0	6,2,0				
				6,2,0				