1
0,10
1,2,3
0,2,3
1,30,1,2,3
	2,3,1,1	3,3,1,0	4,3,999,999		6,3,999,100		8,3,999,999	9,3,0,0	10,3,0,1
1,4,1,2									10,4,0,2
	2,5,1,3	3,5,1,4	4,5,1,5	5,5,1,6		7,5,0,6	8,5,0,5	9,5,0,4	10,5,0,3
				5,6,1,7	6,6,0,7				
	2,7,1,11	3,7,1,10	4,7,1,9	5,7,1,8		7,7,0,8	8,7,0,9	9,7,0,10	10,7,0,11
1,8,1,12									10,8,0,12
	2,9,1,13	3,9,1,14	4,9,1,15				8,9,0,15	9,9,0,14	10,9,0,13