0
1,2200,2500,3000
0,30,1,2,3
1,0,2	2,0,2	3,0,2	4,0,2	5,0,2	6,0,2	7,0,2	8,0,2	9,0,2	10,0,2
1,0,2	2,0,2	3,0,2	4,0,2	5,0,2	6,0,2	7,0,2	8,0,2	9,0,2	10,0,2
	2,0,2	3,1,0	4,1,0	5,1,0	6,3,0	7,3,0	8,3,0	9,3,0	10,0,2
1,1,0	2,2,0	3,1,0	4,0,2	5,3,0	6,1,0	7,0,2	8,1,0	9,3,0	10,3,0
1,2,0	2,0,2	3,0,2	4,0,2	5,2,0	6,2,0	7,3,0	8,0,2	9,0,2	10,0,2
1,0,2	2,2,0	3,1,0	4,0,2	5,1,0	6,1,0	7,0,2	8,1,0	9,3,0	10,0,2
1,3,0	2,0,2	3,3,0	4,3,0		6,1,0		8,2,0	9,2,0	10,0,2
1,1,0	2,0,2	3,3,0					8,2,0	9,0,2	10,3,0
		3,3,0	4,3,0				8,2,0	9,2,0	
	2,3,0	3,3,0					8,2,0	9,2,0	
	2,3,0	3,3,0						9,2,0	10,2,0
1,3,0	2,3,0	3,3,0	4,2,0	5,0,2	6,3,0	7,3,0	8,2,0	9,2,0	10,2,0
	2,1,0	3,2,0	4,1,0	5,2,0	6,0,2	7,0,2	8,0,2	9,0,2	10,1,0
1,3,0	2,3,0	3,2,0	4,3,0	5,1,0	6,3,0	7,2,0	8,1,0	9,0,2	10,1,0
1,2,0	2,0,2	3,0,2	4,0,2	5,0,2	6,0,2	7,0,2	8,0,2	9,0,2	10,2,0
1,1,0	2,0,2	3,2,0	4,2,0	5,2,0	6,1,0	7,2,0		9,2,0	10,3,0
	2,3,0	3,0,2	4,0,2	5,0,2	6,0,2	7,3,0	8,3,0	9,3,0	10,1,0
1,1,0	2,1,0	3,1,0	4,1,0	5,1,0	6,0,2	7,3,0	8,3,0	9,3,0	10,3,0
1,1,0	2,1,0	3,1,0	4,1,0	5,0,2	6,0,2	7,0,2	8,3,0	9,3,0	10,3,0
1,0,2	2,1,0		4,1,0			7,3,0		9,3,0	10,0,2
	2,0,2	3,0,2	4,0,2	5,0,2	6,0,2	7,0,2	8,0,2	9,0,2	10,0,2
	2,0,2	3,2,0	4,2,0	5,2,0	6,2,0	7,2,0	8,2,0	9,0,2	
		3,0,2	4,2,0	5,2,0	6,2,0	7,2,0	8,2,0	9,0,2	
		3,0,2	4,2,0	5,2,0	6,2,0	7,2,0	8,0,2		
			4,0,2	5,0,2	6,2,0	7,0,2	8,0,2		