0
2,5000,5400,5800
1,37,1,2,3
1,2,0		3,1,0	4,2,0	5,1,0	6,2,0	7,3,0	8,1,0	9,1,0	
1,2,0	2,3,0	3,3,0	4,1,0			7,3,0	8,2,0	9,2,0	10,3,0
1,1,0	2,2,0	3,1,0	4,1,0	5,1,0	6,2,1	7,3,0	8,2,0	9,2,0	10,1,0
	2,3,0	3,2,0	4,1,0	5,1,0	6,1,0	7,2,0	8,3,0	9,2,0	
1,2,0	2,2,0		4,3,0				8,1,0		10,2,0
1,3,0	2,3,0	3,1,0		5,3,0	6,3,0		8,3,0	9,2,0	10,1,0
		3,3,1		5,3,0	6,3,0	7,3,0		9,3,1	
	2,3,0	3,1,0	4,3,0	5,1,0	6,3,0	7,3,0	8,3,0	9,1,0	
		3,1,0	4,3,0	5,1,0		7,3,0	8,3,0	9,2,0	
		3,3,0	4,3,0			7,3,0	8,3,0		
	2,2,0	3,1,0	4,1,0	5,2,0	6,2,0	7,2,0	8,1,0	9,3,0	10,1,0
		3,1,1	4,1,0	5,2,0	6,2,0	7,2,0	8,3,1		
		3,2,0		5,2,0	6,2,0	7,2,0		9,2,0	
			4,2,0	5,2,0	6,2,0	7,1,0			
		3,3,0	4,3,0	5,1,0	6,1,0	7,1,0	8,3,0	9,1,0	
	2,1,0		4,1,0	5,1,0	6,1,0	7,1,0		9,3,0	
	2,2,0	3,2,0		5,1,0	6,1,0	7,3,0		9,2,0	10,2,0
1,1,0		3,2,0	4,3,0	5,1,0	6,1,0	7,1,0	8,3,0		10,1,0
	2,3,0	3,3,0	4,3,0	5,1,0	6,1,0	7,1,0	8,3,0	9,3,0	10,3,0
1,1,0	2,1,0	3,1,0	4,1,0	5,2,1	6,3,1	7,2,0	8,1,0	9,3,0	10,1,0
1,2,0	2,1,0		4,2,0	5,1,1		7,1,1	8,3,0		10,1,0
1,3,0	2,3,0	3,3,0	4,3,0	5,3,0	6,2,0	7,2,0	8,2,0	9,2,0	10,2,0
1,3,0	2,3,0	3,3,0	4,3,0	5,3,0		7,2,0	8,2,0	9,2,0	10,2,0
1,3,0	2,3,0	3,3,0					8,2,0	9,2,0	10,2,0
1,2,0	2,2,0								10,2,0