0
1,3000,4000,5000
1,32,1,2,3
	2,2,0	3,2,0	4,3,0	5,3,0	6,2,0	7,3,0	8,3,0	9,1,0	10,1,0
	2,2,0	3,2,3	4,0,2	5,2,0	6,2,0	7,0,2	8,1,3	9,1,0	
		3,2,0	4,0,2	5,3,0	6,3,0	7,3,0	8,0,2	9,1,0	
	2,1,0	3,1,0	4,1,0	5,3,0	6,3,0	7,2,0	8,2,0	9,2,0	
		3,1,0	4,1,0		6,3,3		8,2,0	9,2,0	
		3,1,0		5,2,0	6,2,0		8,2,0		
		3,3,0	4,3,0	5,3,3	6,0,2	7,1,3	8,1,0	9,1,0	
		3,3,0	4,3,0	5,0,2	6,0,2	7,1,0	8,1,0		
			4,3,0	5,2,0	6,2,0	7,2,0	8,1,0		
		3,1,0	4,1,0	5,2,0	6,2,0	7,1,0	8,2,0		
			4,2,0	5,3,0	6,2,3	7,1,0	8,1,0		
			4,2,0	5,3,0	6,2,0	7,2,0			
1,1,0	2,1,0	3,2,3	4,3,0	5,3,0	6,3,0	7,1,0	8,2,0	9,2,3	10,3,0
1,2,0	2,0,2	3,0,2	4,0,2	5,0,2	6,0,2	7,0,2	8,0,2	9,0,2	10,2,0
1,3,0	2,3,0	3,1,0	4,2,0	5,1,0	6,2,0	7,1,0	8,1,0	9,1,3	10,0,2
1,1,0	2,0,2	3,0,2	4,0,2	5,0,2	6,0,2	7,0,2	8,0,2	9,0,2	10,3,0
1,3,0	2,0,2	3,1,3	4,1,0	5,3,0	6,3,0	7,1,0	8,1,0	9,3,0	10,2,0
1,1,0	2,0,2	3,0,2	4,0,2	5,0,2	6,0,2	7,0,2	8,0,2	9,0,2	10,2,0
	2,2,0	3,0,2	4,2,0	5,2,0	6,2,0	7,2,0	8,1,0	9,3,3	10,0,2
1,3,0	2,0,2	3,3,0	4,3,0	5,3,0	6,0,2	7,0,2	8,0,2	9,0,2	10,3,0
		3,1,0	4,3,0	5,3,0	6,0,2	7,1,0	8,1,0	9,1,0	
		3,1,0	4,1,0			7,2,0	8,3,0		
			4,2,0	5,3,0	6,2,0	7,2,0	8,3,0		
		3,2,0	4,3,3	5,1,0	6,3,0	7,3,3	8,3,0		
1,2,0	2,1,0	3,2,0	4,2,0	5,1,0	6,3,0	7,1,0	8,3,0	9,3,0	10,1,0
1,1,0	2,2,0	3,2,3	4,2,0			7,3,0	8,3,3	9,3,0	10,2,0
1,1,0	2,1,3	3,0,2	4,3,0	5,1,0		7,1,0	8,1,0	9,0,2	10,2,3
1,1,0	2,1,0	3,0,2	4,2,0	5,1,0	6,1,0	7,2,0	8,0,2	9,2,0	10,2,0
1,3,0	2,3,3	3,3,0	4,0,2	5,1,0	6,1,0	7,2,0	8,0,2	9,1,0	10,1,3
1,3,0	2,3,0	3,3,0	4,0,2			7,0,2	8,1,0	9,1,0	10,1,0
			4,0,2				8,0,2		
		3,3,0					8,2,0		
			4,3,0					9,2,0	
		3,3,0					8,2,0		
			4,3,0					9,2,0	
		3,3,0					8,2,0		
			4,3,0					9,2,0	
		3,3,0					8,2,0		
			4,3,0					9,2,0	
		3,3,0	4,1,0				8,1,0	9,2,0	
			4,3,0	5,1,0		7,1,0	8,2,0		
		3,3,0		5,1,0	6,1,0		8,2,0		
		3,3,0	4,1,0	5,1,3		7,1,3	8,1,0	9,2,0	
			4,1,0			7,1,0			