0
2,1100,6000,7000
1,34,1,2,3
					6,2,0				
		3,2,0		5,3,0	6,2,0		8,1,0	9,3,0	
	2,2,3	3,0,2	4,1,0		6,1,0		8,1,0	9,0,2	10,1,0
	2,2,0	3,2,0	4,1,3	5,2,0	6,1,0	7,2,0	8,3,0	9,3,0	
	2,1,0			5,3,0	6,0,2	7,1,3			10,2,0
1,1,0				5,3,0	6,1,0				10,2,0
	2,2,0	3,3,0	4,2,0				8,2,0	9,1,0	10,3,0
	2,3,0	3,0,2	4,1,0		6,1,0	7,2,0	8,0,2	9,1,0	
		3,1,0	4,3,1		6,2,0		8,3,0	9,3,3	
				5,1,0	6,2,1				
				5,2,0	6,0,2	7,2,0			
				5,2,3	6,2,0				
					6,1,0				
	2,3,0	3,1,0		5,2,0	6,1,0		8,2,3	9,3,0	
	2,3,3	3,0,2	4,1,1		6,2,0		8,3,0	9,0,2	10,2,0
	2,3,0	3,3,0	4,2,0	5,1,0	6,2,0	7,2,0	8,1,0	9,1,0	
	2,3,0			5,3,0	6,0,2	7,2,0			10,3,0
1,3,0				5,1,0	6,1,1				10,3,0
	2,1,1	3,3,0	4,2,0		6,1,0		8,1,0	9,1,0	10,2,0
	2,3,3	3,0,2	4,3,3	5,3,0	6,1,0	7,3,0	8,0,2	9,1,0	
		3,1,0	4,1,0		6,3,0		8,3,0	9,1,3	
				5,3,0	6,3,0				
				5,2,0	6,0,2	7,3,3			
				5,2,1	6,2,0				
					6,3,0				
	2,2,0	3,1,0		5,2,0	6,3,0		8,2,0	9,3,0	
	2,2,1	3,0,2	4,3,0		6,3,0		8,3,3	9,0,2	10,2,0
	2,2,0	3,1,3	4,1,0	5,1,0	6,1,0	7,1,0	8,2,0	9,1,0	
	2,1,0			5,1,3	6,0,2	7,1,1			10,2,0
1,3,0				5,2,0	6,1,0				10,2,0
	2,2,0	3,3,3	4,3,0		6,1,0		8,2,0	9,1,1	10,2,0
	2,3,0	3,0,2	4,2,0	5,1,0	6,3,0	7,2,0	8,0,2	9,1,0	
		3,1,0	4,3,0		6,1,0		8,3,0	9,3,0	
				5,3,0	6,2,3				
				5,1,1	6,0,2	7,2,0			
				5,2,3	6,2,0				